I won't see him anymore.	No el veuré mai més.
I would like to rent a car.	Voldria llogar un cotxe.
It's a topic that's not often discussed.	És un tema del qual se sol parlar poc.
What's happening tonight?	Què està passant aquest nit?
Have you had your supper?	Ja heu sopat?
A can of beer tastes better after a day of hard work.	Una llauna de cervesa fa més bon gust després d'un dia de treballar de valent.
Tom wants to change the world.	En Tom vol canviar el món.
He is getting better bit by bit.	Està millorant poc a poc.
What little money I had was stolen.	Els pocs diners que tenia me'ls van robar.
We need to invest in clean, renewable energy.	Hem d'invertir en energia neta i renovable.
My sister hit the jackpot.	A la meva germana li va tocar la grossa.
Iron is used for ship building.	El ferro s'usa per a construir vaixells.
I want to introduce you to the man I spoke about the other day.	Tinc desig de presentar-vos l'home de qui vaig parlar l'altre dia.
I can't solve that problem.	No puc solucionar aquell problema.
Tom said that he's glad that you were able to do that.	En Tom va dir que estava content que haguessis pogut fer allò.
Tom is able to understand French fairly well, but he doesn't speak it so well.	En Tom entén prou bé el francès, però no el parla tan bé.
The photo was a hoax.	La foto era un frau.
Have you eaten breakfast already?	Ja has esmorzat?
Speaking of last night, what time did you get home?	Parlant de la nit d'ahir, a quina hora vas arribar a casa?
The policewoman directed traffic.	La policia dirigia el trànsit.
I know that Tom is a very clumsy guy.	Sé que el Tom és bastant sapastre.
Give him this message the moment he arrives.	Dóna-li aquest missatge quan arribi.
She's curious to find out who sent the flowers.	Ella té curiositat per saber qui va enviar les flors.
My father quit drinking.	Mon pare va deixar de beure.
I want to live in a quiet city where the air is clean.	Vull viure a una ciutat tranquila amb l'aire pur.
Who are you?	Qui és vostè?
I thought I was having a heart attack.	Em pensava que estava tenint un atac de cor.
I'd like to go out with you.	Voldria sortir amb tu.
Your opinion is irrelevant.	La teua opinió és irrellevant.
Do they have any good news?	Tens bones notícies?
We have yellow apples.	Nosaltres tenim les pomes grogues.
I work at a language school.	Treballo en una escola d'idiomes.
I'm sure the weather will be nice tomorrow.	Segur qu demà farà bon temps.
I know that Tom is nearby.	Sé que en Tom està a prop.
I work in a bank.	Jo treballo a un banc.
They have enough money.	Tenen prou diners.
Can you delete this photo?	Pots esborrar aquesta foto?
It's even worse than it looks.	És inclús pitjor del que es veu.
I went to the station.	Vaig anar a l'estació.
Nobody is perfect.	Ningú és perfecte.
They're not going to let anything happen to Tom.	No permetran que res li succeeixi a en Tom.
Tom spent weeks preparing for his trip.	En Tom va passar-se setmanes preparant-se per al seu viatge.
What would you like to eat?	Què voldràs de menjar?
I'd like to go with Tom.	M'agradaria anar amb en Tom.
Get me something to drink, please.	Doni'm alguna cosa per beure, si us plau.
The food didn't taste very good.	El menjar no tenia gaire bon gust.
This is perfectly normal.	Això és del tot normal.
Mathematics is important in daily life.	Les matemàtiques són importants a la vida diària.
It was a party to celebrate her birthday.	Era una festa per a celebrar el seu aniversari.
I felt like I would die.	Sentia que em moriria.
I have nothing to say to any of you.	No tinc res a dir-vos a cap de vosaltres.
Tom said that you were going to Boston.	El Tom va dir que marxaves a Boston.
Drink some coffee. It tastes very good, I think.	Pren una mica de cafè. Té molt bon gust, crec.
Tom is accustomed to calling up girls on the telephone.	En Tom acostuma a trucar noies.
Come with us.	Vine amb nosaltres.
You can't park in a handicapped parking space unless you have a special permit.	No pots aparcar a una plaça d'aparcament per discapacitats si no tens un permís especial.
I noticed that she sat in the front row.	Vaig notar que ella va seure a la fila del davant.
It's a topic that isn't often discussed.	És un tema del qual se sol parlar poc.
I might need to stay in Boston for a few more days.	Potser encara necessiti estar a Boston uns dies més.
You disappointed me.	M'has decebut.
Night is when most people go to bed.	La nit és quan la majoria de la gent se'n va al llit.
It's strange that our friends aren't here.	És extrany que els nostres amics no estiguin aqui.
Japan imports great quantities of crude oil.	El Japó importa una gran quantitat de petroli.
I'd like to get to know Tom.	M'agradaria conèixer en Tom més a fons.
Fish live in the sea.	Els peixos viuen al mar.
I was caught in a shower on the way.	M'ha enxampat un xàfec pel camí.
The food didn't taste very good.	El menjar no feia gaire bon gust.
Who painted it?	Qui ho ha pintat?
Everyone loves him.	Tots l'estimen.
Nobody equals him in strength.	Ningú no li fa ombra.
Everything is perfect.	Tot està perfecte.
You'll need to come back before it gets dark.	Hauries de tornar abans que es fes fosc.
Where will you be staying?	On t'estaràs?
Where will we go afterwards?	On anirem després?
You weren't wrong.	No estaves equivocat.
Do you support or oppose the death penalty?	Estàs a favor o en contra de la pena de mort?
All my friends like playing videogames.	A tots els meus amics els agraden els videojocs.
When did that happen to you?	Quan et va passar allò?
That was a very risky thing to do.	Era una cosa molt arriscada de dur a terme.
They never returned to their country.	No van tornar mai al seu país.
Go to sleep, Tom.	Cap al llit, Tom.
They fell into the conversation immediately.	Van passar al tema a l'instant.
Are you an idiot?	Ets idiota?
Don't ever do that again.	No ho facis mai més.
She is giving a party tonight.	Ella fa una festa aquesta nit.
Tom's arm had to be amputated.	Li van haver d'amputar el braç a Tom.
She is a good swimmer.	És una bona nedadora.
He left the book on the table.	Va deixar el llibre sobre la taula.
Is there any other way to get there?	Hi ha alguna altra manera d'arribar allà?
You treated me like a little kid.	Em vas tractar com si fos un nen petit.
I hope that I can do it.	Espere poder-ho fer.
How do you deal with writer's block?	Com treballes el teu bloqueig escriptor?
It seems those two are made for each other.	Sembla que aquell parell estan fets l'un per l'altre.
I'd like to reserve a table for two.	M'agradaria reservar una taula per a dos.
I really need to take care of some business.	He de tenir cura d'alguns negocis.
I have lost my key.	He perdut la meva clau.
I'd like to go out with you.	M'agradaria sortir amb tu.
You're ridiculous.	Ets ridícula.
The sun appeared on the horizon.	El Sol apareix a l'horitzont.
The flood caused a lot of damage.	La inundació va fer molt de mal.
If only I knew, I would tell you all that I knew.	Si ho sabés, et diria tot el que sé.
Who wrote the letter?	Qui ha escrit la carta?
I have a problem.	Tinc un maldecap.
That happened a year ago.	Això va passar fa un any.
I don't know the reason why he went there.	No sé el motiu pel qual va anar-hi.
I didn't know you'd come back.	No sabia que havies regressat.
Here is your bag.	Ací està la teua bossa.
I know that there was a big church here.	Sé que aquí hi havia una església gran.
There are billions of stars in the sky.	Hi ha mil milions d'estrelles al cel.
Happy New Year!	Bon any nou!
Do you come here every day?	Véns aquí cada dia?
My friend doesn't believe that ghosts exist.	El meu amic no creu que els fantastes existeixin.
I wrote a letter.	Vaig escriure una carta.
I think he'll never return.	Crec que mai no tornarà.
I wish I could buy that guitar.	M'agradaria poder comprar eixa guitarra.
I saw him jump.	El vaig veure saltar.
Columbus discovered America.	Colón va descobrir Amèrica.
We'll convince Tom.	Convencerem en Tom.
I'm busy, so I can't help.	Estic ocupat, no puc ajudar-vos.
Look that word up in the dictionary.	Cerca aquella paraula al diccionari.
What are you doing tomorrow?	Què fas demà?
He is a very thoughtful person.	És una persona molt considerada.
Tom doesn't like confrontation.	A en Tom no li agrada la confrontació.
Rainy days make me sad.	Els dies de pluja em posen trist.
"Is she reading a book?" "Yes, she is."	"Està llegint un llibre?" "Sí."
Why don't you stay for a bit?	Us quedeu una estona?
It's very symbolic.	És molt simbòlic.
Europe is in crisis.	Europa està en crisi.
I didn't know you'd come back.	No sabia que havies tornat.
Tom doesn't know the details.	Tom no coneix els detalls.
My mother knows how to make cakes.	La meva mare sap com fer pastissos.
I have a son who's an athlete.	Tinc un fill atleta.
Tom is a bad influence on you.	En Tom és una mala influència per a tu.
You let me down.	M'has decebut.
I like cats.	M'agraden els gats
The photo was a hoax.	La foto era falsa.
Your father is tall.	Ton pare és alt.
She hated him.	Ella l'odiava.
I like walking.	M'agrada caminar.
Let me see if Tom has changed his mind.	Deixa'm veure si en Tom ha canviat d'idea.
Why are you not in your office?	Per què no estàs a la teua oficina?
How long has it been there?	Quant de temps hi ha estat?
Is racism a serious issue?	El racisme és un assumpte seriós?
Turn the TV down, please.	Baixa el volum del televisor.
Tom couldn't imagine his life without Mary.	En Tom no podia imaginar la seva vida sense la Maria.
Take off your socks, please.	Sisplau, lleva't els mitjons.
I only have eyes for you.	Aquí no veig ningú més que tu.
What you think is irrelevant.	El que penses és irellevant.
I'm sorry, my father is out.	Em sap greu, però el meu pare no és a casa.
I demanded that he pay the bill immediately.	Li vaig demanar de pagar la factura immediatament.
I'd like to go with you if you don't mind.	Si no us importa, m'agradaria anar amb vosaltres.
I want to see the ocean.	Vull veure l'oceà.
She's Tom's younger sister.	És la germana menuda de Tom.
I really must have my watch repaired.	He de dur el rellotge a arreglar.
I'm not angry with you.	No estic enfadada amb tu.
Didn't you know that?	No ho sabies?
I just want to be near you.	Només vull estar prop de tu.
He had a firm belief in his God.	Té una creença ferma en Déu.
Don't do that unless Tom says you have to do it.	No ho facis tret que en Tom et digui que has de fer-ho.
Good night, everyone!	Bona nit a tothom!
It is difficult to speak three languages.	És difícil parlar tres llengues.
I'm desperate.	Estic desesperat.
I'd like to get a copy of that report.	Voldria una còpia de l'informe.
Tom hasn't sharpened the knives yet.	En Tom encara no ha afilat els ganivets.
I am now on duty.	Ara estic de servei.
I don't want to work.	No vull treballar.
We have to obey the rules.	Hem de seguir les regles.
The doctor says that I'll never be able to swim again.	El metge diu que no tornaré a ser capaç de nedar.
My friend doesn't believe that ghosts exist.	La meva amiga no creu que els fantastes existeixin.
I'd like to get you both to help me.	M'agradaria que tots dos m'ajudéssiu.
I have to go to sleep.	He d'anar a dormir.
She kept the dining room warm in the winter.	Ella mantenia el menjador calent a l'hivern.
You don't have to do this.	Això no ho has de fer.
Some animals eat their young.	Alguns animals es mengen les seves cries.
I wanted to go to the beach today, but then it started to rain.	Volia anar a la platja avui, però llavors ha començat a ploure.
Tom doesn't quite buy it.	En Tom no s'ho creu gaire.
I can't remember where I bought it.	No recordo on el vaig comprar.
For the first time in more than 6 years, the unemployment rate is below 6%.	Per primera vegada en més de 6 anys, la taxa d'atur està per davall del 6%.
How much time do you spend on Facebook?	Quant de temps passes a Facebook?
I made her a dress.	Li vaig fer un vestit.
I'm gaining weight.	Estic guanyant pes.
They work eight hours a day.	Treballen vuit hores al dia.
Time flies.	El temps vola.
You're not a child anymore.	Ja no ets un nen.
The girl said nothing.	La nena no va dir res.
I don't think we can take that risk.	Crec que no podem córrer eixe risc.
My father died before I was born.	Mon pare va morir abans que jo nasquera.
I don't have the strength to keep trying.	No tinc la força per continuar triant.
I, too, didn't understand anything.	Jo tampoc entenc res.
I know those bars.	Jo conec aqueixos bars.
Don't cry, Tom.	No ploris, Tom.
I stayed in bed one more day just to be on the safe side.	Em vaig quedar un dia més al llit per si de cas.
Tom is a thirteen-year-old boy from Australia.	En Tom és un nen de tretze anys d'Austràlia.
Mary's doctor advised her to exercise.	El metge de la Mary li va aconsellar que fes exercici.
I didn't show those pictures to anyone.	No vaig ensenyar aquelles fotos a ningú.
We must control our passions.	Hem de controlar les nostres passions.
People want to feel safe.	La gent vol sentir-se segura.
Let me have a try.	Deixa'm intentar-ho.
I'm a salesperson.	Sóc venedor.
Too late.	Massa tard.
Tom is making great progress in French.	En Tom està progressant molt amb el francès.
I caught the ball with one hand.	Vaig agafar la pilota amb una mà.
She came back ten minutes after the explosion.	Ella va tornar deu minuts després de l'explosió.
I dislike big cities.	No m'agraden les ciutats grans.
He goes to the office by car.	Va al despatx amb cotxe.
I know everything about you.	Ho sé tot de tu.
Who let you come in?	Qui t'ha deixat passar?
Is racism a serious issue?	El racisme és una qüestió seriosa?
You need to hurry.	T'has d'afanyar.
Do you have two books?	Tens dos llibres?
Will the work be finished by tomorrow?	Estarà enllestida la feina per a demà?
Blue lines on the map designate rivers.	Les línies blaves al mapa designen rius.
Everything was fine until Tom set the house on fire.	Tot estava bé fins que en Tom va incendiar la casa.
She raised her hand.	Ella alçà la mà.
Tom is such a good French speaker.	En Tom és un francòfon tan bo.
This lake's water is clean.	L'aigua d'aquest llac està neta.
He decided to become a pilot.	Va decidir fer-se pilot.
I saw him tear up the letter.	El vaig veure estripar la carta.
The secret of longevity is to choose your parents carefully.	El secret de la longevitat és triar amb compte els pares.
Did you bring what I asked you to bring?	Has portat el que et vaig demanar que portessis?
Tom cut his finger when he was opening a can.	En Tom es va tallar el dit mentre obria una llauna.
Everything in the world is nothing more than a dream.	Tot el que hi ha a aquest món no és més que un somni.
I've had a very hard day.	He tingut un dia molt dur.
I don't like big cities.	No m'agraden les ciutats grans.
Don't be like Tom.	No siguis com en Tom.
I have to buy one tomorrow.	He de comprar-ne un demà.
Racism is a serious issue.	El racisme és un problema seriós.
I don't have anything to say to any of you.	No tinc res a dir-vos a cap de vosaltres.
Can your mom drive a car?	La teua mare sap conduir un cotxe?
That pair of pliers came in handy.	Aquelles alicates em van ser molt útils.
I must discuss the new plan with Tom.	He de debatre el nou pla amb en Tom.
She made the same mistake again.	Ella va cometre una altra vegada la mateixa errada.
The girl dressed in white is his fiancée.	La noia vestida de blanc és la seva xicota.
Is anybody here willing to do that?	Algú està disposat a fer allò?
When can we see each other again?	On ens podem tornar a veure?
They agreed to elect him as president.	Es van posar d'acord per triar-lo com president.
I did basically the same thing as Tom did.	He fet bàsicament el mateix que ha fet el Tom.
We look ridiculous.	Ens veiem ridículs.
She bought that camera while she was in Japan.	Ella va comprar aquella càmera quan era al Japó.
Can he speak English?	Que parla anglès, ell?
Everyone likes big pizzas.	A tothom li agraden les pizzes grans.
Who are you?	Qui ets tu?
Tom visited Mary's grave.	En Tom va visitar la tomba de la Mary.
Are you blushing?	Que t'enrojoles?
I'll walk.	M'aniré caminant.
I'm locked out of my room.	Estic atrapat fora de la meva cambra.
Have you had tea?	Ja heu sopat?
He died three years ago.	Va morir fa tres anys.
You should've told me yesterday.	M'ho hauries d'haver dit ahir.
Exercise every day.	Fes exercici cada dia.
They all looked for the lost child.	Tots buscaven el nen perdut.
This story is far more interesting than that one.	Aquesta història és molt més interessant que aquella.
I'm fed up with him always preaching to me.	Estic tip dels seus sermons constants.
I'm the one who has the key.	Jo sóc qui té la clau.
What great news!	Quina bona nova!
Have you ever done it?	Ho has fet mai?
She hates carrots.	Ella odia les pastanagues.
Does he speak English?	Ell parla anglès?
Come whenever you like.	Vingui quan vulgui.
Tom wasn't sure what he should do next.	En Tom no estava segur de què hauria de fer després.
I'm fed up with him always preaching to me.	Estic tip que em sermonegi constantment.
I still need to get a haircut.	Encara em fa falta tallar-me els cabells.
They aren't my real parents.	Ells no són els meus vertaders pares.
I will get in touch with you.	Em posaré en contacte amb tu.
Come on, it's not that hard.	Vinga, que no és tan complicat.
I don't have time now.	Ara no tinc temps.
The elevator is out of order today.	L'ascensor no funciona avui.
It takes about 10 minutes to get to the train station by foot.	Tens uns 10 minuts d'aquí a l'estació a peu.
Many trees fell down.	Van caure molts arbres.
Today's meeting has been canceled.	La reunió d'avui ha sigut cancelada.
You have to take a look at the patient.	Has de fer-li una ullada al malalt.
I want to make sure we have enough water.	Vull estar segur que tenim suficient aigua.
Tom said he thought that Mary would unlikely do that.	En Tom va dir que no es pensava que la Maria ho fes.
This is a pear.	Això és una pera.
Tell me when he returns.	Avisa'm quan torni.
Are you insane?	Estàs boig?
I'll find the solution.	Hi trobaré la solució.
I have nothing in common with her.	No tinc res en comú amb ella.
I don't want sugar.	No vull sucre.
The girl didn't say anything.	La nena no va dir res.
No one knows why Tom hasn't done that.	Ningú sap perquè el Tom no ho ha fet.
This is the best book that I've ever read.	És el millor llibre que he llegit mai.
He has never played golf.	Ell no ha jugat mai al golf.
Tom chickened out.	En Tom es va acollonir.
Tom never told us why he did that.	En Tom mai no ens va dir per què ho havia fet.
What languages are spoken in America?	Quins idiomes es parlen a Amèrica?
Who are you all?	Qui sou totes vosaltres?
Flowers die if they don't have water.	Sense aigua les flors es panseixen.
If you don't eat, you'll die.	Si no menges, et mors.
Why are you taking so much medicine?	perquè prens tant de medicament?
I don't love you anymore.	Ja no t'estimo.
I left.	M'en vaig anar.
Do you have to go anywhere else?	Que has d'anar a cap altre lloc?
We're all safe.	Estem tots bé.
Tom said that Mary has only done that once.	El Tom va dir que la Mary ho havia fet només un cop.
I plan to visit Boston next summer.	Planifico visitar Boston l'estiu que vé.
He fought against racial discrimination.	Va lluitar contra la discriminació racial.
Is that real money?	Això són diners de veritat?
I'll try it.	La provaré.
This is a very strange letter.	Aquesta és una carta molt estranya.
I'm talking on the phone.	Parlo per telèfon.
Tom isn't a student here. He's one of the teachers.	En Tom no és un estudiant aquí. És un dels mestres.
Many sailors can't swim.	Molts mariners no saben nedar,
I'm always hungry.	Sempre tinc fam.
I know that Tom is a very clumsy guy.	Sé que el Tom és bastant pocatraça.
People of my generation all think the same way about this.	Tota la gent de la meva generació pensen igual sobre això.
Do you listen to podcasts?	Escoltes podcasts?
Thanks!	Gràcies!
I wish I could buy that guitar.	Com voldria poder comprar aquesta guitarra.
I'm stuffed.	Estic molt tip.
Cats prefer fish to meat.	Els gats s'estimen més el peix que la carn.
Thanks for everything.	Mercès per tot.
I'd like to get some sleep.	Voldria dormir una mica.
Life became very difficult.	La vida es va tornar molt difícil.
What did you think of the movie?	Què t'ha semblat la pel·lícula?
Tom said that he tried to help Mary.	El Tom va dir que va intentar ajudar la Mary.
He plays the piano very well.	Ell toca el piano molt bé.
How much time do you spend with your spouse?	Quant de temps passa vostè amb el seu cònjuge?
I bought some stamps.	Vaig comprar alguns segells.
This store sells old books.	Aquesta botiga ven llibres vells.
The body hasn't yet been identified.	El cos no ha estat identificat.
You're still too young to drink.	Encara ets massa jove per a beure.
Who are they talking to?	Amb qui estan parlant?
I told you to be here on time this morning.	Et vaig dir que havies de ser aquí puntual aquest matí.
They're not my real parents.	Ells no són els meus vertaders pares.
I'd like to stay here for one night.	M'agradaria quedar-me aquí una nit.
Tom turned blue.	El Tom va posar-se blau.
I don't want to do it again.	No vull tornar-ho a fer.
What a beautiful sunset!	Quina posta de sol més bonica!
The room is rather small.	La cambra és força petita.
Can you remember the first time you saw Tom?	Podeu recordar el primer cop que heu vist en Tom?
I didn't know you'd come back.	No sabia que regressaries.
Have you ever done it?	Ho has fet algun cop?
Tom hates himself.	En Tom s'odia.
Tom walked alone.	En Tom caminava sol.
I heard him sing at the concert.	El vaig sentir cantant al concert.
You look good.	Tens bona cara.
I like taking walks.	M'agrada caminar.
My daughter won't find it easy to get accustomed to the new school.	La meva filla no trobarà fàcil per acostumar-se a la nova escola.
I knew you were lying.	Sabia que menties.
Are you hungry now?	Teniu fam, ara?
You treated me like a little kid.	Em vas tractar com a una nena petita.
Tom told me the good news.	En Tom m'ha comunicat la bona notícia.
I'd like some aspirin.	Voldria una aspirina.
Tom was discharged today.	Al Tom l'han acomiadat avui.
I've been doing that for several years.	Ho he estat fent moltíssims anys.
That's pure racism.	Això és racisme pur!
I knew that Tom knew who was going to help him do that.	Sabia que en Tom sabia qui l'anava a ajudar a fer-ho.
Tom wants me to play soccer with him.	En Tom vol que jugui a futbol amb ell.
I was not aware of his presence.	Jo no era conscient que ell estava al davant.
Why is it forbidden to fish in this river?	Per què està prohibit pescar en este riu?
I thought that I saw someone I knew.	Em pensava que havia vist algú que coneixia.
She has long hair.	Ella té el cabell llarg.
You should pay more attention to what I say.	Deuries prestar més atenció a allò que dic.
Neither my sister nor I have read this new novel.	Ni jo ni la meva germana no hem llegit aquesta nova novel·la.
I hate coffee.	Detesto el cafè.
I sent a letter to my parents.	Vaig enviar una carta als meus pares.
I know Tom isn't a member of our club.	Sé que en Tom no és membre del nostre club.
He's the oldest son.	Ell és el fill gran.
Our summer is short, but warm.	El nostre estiu és curt, però calorós.
She gave him a present.	Ella li va donar un regal.
He's the one who touched me.	Ell és el que em va tocar.
Go to sleep, Tom.	Ves al llit, Tom.
Sorry for being late.	Perdó pel retard.
I always get nervous in her presence.	La seva presència em posa sempre nerviós.
My friend doesn't believe that ghosts exist.	La meva amiga no es creu que els fantastes existeixen.
You look good.	Fas bona cara.
It's always been that way.	Sempre ha sigut així.
I recognized him at once.	El vaig reconèixer de seguida.
Money talks.	Qui paga, mana.
We'll show you how to catch a fish.	T'ensenyarem com atrapar un peix.
What do you want to talk to me about?	De què vols parlar amb mi?
This is the best book I have ever read.	És el millor llibre que he llegit mai.
Does Tom still have a fever?	En Tom encara té febre?
Let me know whenever you come.	Quan vinguis, fes-m'ho saber.
I really liked the dance that we saw yesterday.	Em va agradar molt el ball que vam veure ahir.
Tom went to the cafeteria.	El Tom va anar a la cafeteria.
We have a French test next Monday.	Tenim un examen de Francès el dilluns.
He hates spiders.	Ell avorreix les aranyes.
Money opens all doors.	Els diners obren totes les portes.
You should've stopped.	T'hauries d'haver aturat.
Tom tried to tell Mary what he was planning to do.	En Tomàs va intentar comunicar a la Maria el que planejava fer.
My mother is angry.	La meva mare està empipada.
In the alphabet, B comes after A.	En l'abecedari la be va després de la a.
I'd like to go abroad.	M'agradaria anar a l'estranger.
Do you come here every day?	Veniu ací tots els dies?
I need that as soon as possible.	Ho necessito tan aviat com sigui possible.
Was Tom in history class today?	Estava el Tom a classe d'història avui?
Do you wonder why no one trusts him?	T'estranya que ningú hi confiï?
Tom said that he's glad you were able to do that.	En Tom va dir que estava content que haguessis pogut fer allò.
It might be easier for us to do that.	Podria ser-nos més fàcil a nosaltres fer-ho.
Even a child could answer that question.	Fins i tot un nen pot respondre aquesta pregunta.
I don't think we can take that risk.	Crec que no podem córrer aquest risc.
I'd like to forget the whole thing ever happened.	M'agradaria oblidar fins que tot allò ocorregué.
Why are we wasting our time with this?	Per què estem perdent el temps amb això?
What if they said no?	Què si diuen que no?
"Is she reading a book?" "Yes, she is."	"Està ella llegint un llibre?" "Sí."
Do you know his birthplace?	Saps on va néixer?
Leave me alone!	Deixa'm en pau!
As long as there's life, there's hope.	Mentre hi ha vida, hi ha esperança.
We'll never do it again.	No ho farem mai més.
All my friends have girlfriends.	Tots els meus amics tenen xicotes.
Come whenever you like.	Vine quan vulguis.
Bangkok is Thailand's capital city.	Bangkok és la capital de Tailàndia.
Please raise your hand before you speak.	Per favor, alça la mà abans de parlar.
Do you have a mobile phone?	Tens un mòbil?
Tom is vegan.	El Tom és vegà
Why don't you sit down and relax?	Per què no et sentes i et relaxes?
He went to the shop.	Ell va anar a la tenda.
Thank you.	Gràcies!
I didn't pay Tom to do that.	No vaig pagar el Tom per fer-ho.
I'm an office worker.	Sóc un oficinista.
Please correct me if I make a mistake.	Si us plau, corregeix-me si m'equivoco.
When will it be convenient for you to come?	Quan li convendria venir?
There's nobody at the entrance.	No hi ha ningú a l'entrada.
What awful weather!	Quin temps tan dolent!
You're ridiculous.	Ets ridícul.
It's not too hot today.	Avui no fa gaire calor.
She's pregnant.	Ella està embarassada.
I hate karaoke.	Detesto el karaoke.
I can't remember where I bought it.	No recorde on ho vaig comprar.
Can I help you?	Puc ajudar?
I'm not as brave as Tom.	No soc tan valent com en Tom.
Ask me something easier.	Pregunta'm una cosa més fàcil.
I took it for granted that he would pass the exam.	Dono per descomptat que aprovarà l'examen.
This sparrow's wings are broken.	Les ales d'aquest pardal estan trencades.
They say golf is very popular in Japan.	Diuen que el golf és molt popular al Japó.
This isn't for you.	Això no és per a tu.
I think Tom isn't home.	Crec que en Tom no està a casa.
Didn't you know Tom would be upset if he saw you kissing Mary?	No sabies que en Tom s'enutjaria si et veia besar la Maria?
I'm a redhead.	Sóc pèl-roja.
I'm at home.	Estic a casa.
Tom was discharged today.	Al Tom l'han llicenciat avui.
How many questions did you answer?	Quantes preguntes has contestat?
Tom is a pretty nice person once you get to know him.	Un cop el coneixes, t'adones que en Tom és una persona prou simpàtica.
They say that love is blind.	Es diu que l'amor és cec.
How much does he earn per month?	Quant guanya al mes?
Do you have a book to read?	Tens algun llibre per llegir?
Tom likes talking about politics and philosophy.	A en Tom li agrada parlar de política i filosofia.
I felt the same.	Em sentia igual.
Where will Tom be sleeping?	On dormirà en Tom?
I remember what he said.	Recordo el que va dir.
You should ask Tom to do that for you.	Li hauries de demanar al Tom que ho faci per tu.
Who's coming with me?	Qui ve amb mi?
Tom and Mary sang a Christmas song.	En Tom i la Maria van cantar una cançó de Nadal.
I believe the choice is clear.	Crec que l'elecció està clara.
Tom couldn't find the light switch.	En Tom no podia trobar l'interruptor del llum.
The teacher told me to study harder.	El professor em va dir que estudiés molt.
You are lost, aren't you?	T'has perdut, no és així?
He has a dog.	Ell té un gos.
Tom thinks women in America wear too much perfume.	En Tom pensa que als Estats Units les dones duen massa perfum.
How can you be sure that's going to happen?	Com pots estar segur que passarà?
She's Tom's younger sister.	És la germana petita d'en Tom.
Would you draw me a map?	Em faríes un mapa?
But why is it all so secret?	Però per què és tot tan secret?
Don't make me wait like this.	No em facis esperar així.
You treated me like a little kid.	Em vas tractar com si fos una nena petita.
Tom said he's glad you were able to do that.	En Tom va dir que estava content que haguessis pogut fer allò.
Tom will likely be discharged from the hospital tomorrow.	Demà donaran d'alta de l'hospital en Tom.
I'd like to give this to you, Tom.	M'agradaria donar-te això, Tom.
Where are our umbrellas?	On estan els nostres paraigües?
How much does he earn in a month?	Quant guanya al mes?
There were ten eggs in all.	Hi havia deu ous en total.
She's pregnant.	Està embarassada.
I didn't know that Tom was in town.	No sabia que en Tom era al poble.
I had fun hanging out with Tom last weekend.	M'ho vaig passar pipa el cap de setmana passat quan vaig sortir amb en Tom.
I didn't do what I was asked to do.	No vaig fer el que se m'havia demanat.
Tom is interested in French literature.	En Tom està interessat en la literatura francesa.
You can come with me.	Pots venir amb mi.
I've been waiting for this day to come.	He estat esperant que arribi aquest dia.
I thanked him for what he had done.	Li vaig agrair el que va fer.
How many letters are there in the alphabet?	Quantes lletres conté l'alfabet?
I lived in Boston before I moved to Chicago.	Vivia a Boston abans de mudar-me a Chicago.
I didn't suspect anything.	No sospitava res.
Can I buy a ticket for the concert here?	Puc comprar aquí una entrada per al concert?
We've all been there.	Tots hem viscut això.
Write these words down in your notebook.	Escriu aquestes paraules al teu quadern.
Tom will likely be the first person to leave.	El Tom marxarà el primer probablement.
The servant cleaned the floor.	El servent va netejar el terra.
He studies contemporary literature.	Ell estudia literatura contemporània.
I know I can't throw a ball very well.	Sé que no tinc la mà trencada a llençar boles.
As we go up higher, the air becomes cooler.	Com més amunt anem, més fresc és l'aire.
Will you please stop talking about food?	Podries deixar de parlar de menjar?
This is your dog.	Aquest és el teu gos.
Tom is a history teacher.	En Tom és un professor d'història.
It's your fault.	És culpa teva.
It's a piece of cake.	Això és bufar i fer ampolles.
We need help.	Ens cal ajuda.
I'd like to get back to work.	M'agradaria tornar a la feina.
I can't remember where I bought it.	No puc recordar on el vaig comprar.
Are we talking about the same Tom?	Estem parlant del mateix Tom?
Is there anything Tom won't do?	Hi ha res que el Tom no faria?
Really?	De veritat?
She can speak Japanese.	Ella sap parlar japonès.
They were satisfied.	Estaven satisfets.
Who buys this type of art?	Qui compra aquest tipus d'art?
I wonder what's going on in there.	Em pregunto què està passant allà dins.
I will go on foot.	M'aniré caminant.
Nobody understands me.	Ningú no m'entén.
Wow!	Carai!
Tom noticed that Mary was having trouble breathing.	El Tom va veure que la Mary tenia problemes per respirar.
Trees shelter my house from the wind.	Els arbres protegeixen la meva casa del vent.
I thought she was angry and would just go away.	Vaig pensar que s'havia enfadat i que se n'aniria.
We're not the police.	No som la policia.
Tom is sick, so he can't do that today.	El Tom està malalt, pel que no podrà fer això avui.
I didn't say it.	No ho he dit pas.
I know that Tom is in Australia now.	Sé que en Tom és a Austràlia ara mateix.
I've been really busy lately.	He estat molt ocupat recentment.
Clouds are what I most like about the sky.	Els nuus són el que més m'agrada del cel.
Where are you going?	A on vas?
I'm very slow at making up my mind.	Sóc molt lent a l'hora de prendre decisions.
I don't know what has happened to him.	No sé què li ha passat.
Tom chickened out.	A en Tom li va agafar cangueli.
Do you want to leave?	Et vols anar?
Thank you so much for inviting me.	Moltes gràcies per la invitació.
We'll never do it again.	No ho tornarem a fer mai més.
Do you want to play tennis with us?	Vols jugar a tennis amb nosaltres?
I have a lot of money in my savings account.	Tinc molts diners al meu compte d'estalvi.
You can always count on Tom.	Sempre pots confiar en en Tomàs.
I don't know whether it is true or not.	No sé si és veritat o no.
Tom teaches French literature.	En Tom ensenya literatura francesa.
Are you following me?	M'estàs seguint?
You don't have to eat it.	Vostè no ha de menjar-ho.
What really happened to us?	Què ens va passar en realitat?
Do you live in Tokyo?	Vius a Tokyo?
Where's the nearest travel agency?	On és l'agència de viatges més propera?
This sparrow's wings are broken.	Les ales d'aquest teuladí estan trencades.
We killed time playing cards.	Matàvem el temps jugant a les cartes.
Please turn off the light.	Per favor, apaga el llum.
Japan is smaller than Canada.	El Japó és més petit que el Canadà.
Have you already had breakfast?	Ja has esmorzat?
Could you tell me the time?	Em podries dir l'hora?
Three boys were standing in front of me.	Hi havia tres nois al meu davant.
Tom isn't the only one here who's hungry.	En Tom no és l'únic aquí famolenc.
I didn't know what to do.	No sabia què fer.
What would you like?	Què desitja vostè?
Don't you like Chinese food?	No t'agrada el menjar xinès?
I sent a letter to my parents.	Envií una carta als meus pares.
Can you see that house over there?	Veus la caseta d'allà?
They are at 229 Broadway Avenue.	Ells estan a l'avinguda Broadway, número 229.
This coat fits you.	Aquest abric et queda bé.
It takes us thirty minutes to walk from here to the station.	D'aquí a l'estació triguem mitja hora a peu.
I've still got to take my pills.	Encara haig de prendre'm les meves píldores.
Get out!	Fora!
How can you eat an enchilada without salsa?	Com et pots menjar una entxilada sense salsa?
I'd like to get some sleep.	M'agradaria dormir una mica.
She raised her hand.	Ella va aixecar la mà.
What's wrong with you?	Què et passa?
The soldier gave water to me.	El soldat m'ha donat aigua.
Tom studied literature in college.	En Tom va estudiar literatura a la universitat.
I'd like to forget the whole thing.	M'agradaria oblidar tot allò.
She had a strange hat on.	Ella portava un barret estrany.
Last night we worked until 10 p.m.	Ahir a la nit vàrem treballar fins a les deu.
I didn't realize that you didn't know how to speak French.	No m'havia adonat que no saps francès
I wish I could buy that guitar.	Tant de bo pogués comprar aquesta guitarra.
Can your mom drive a car?	Ta mare sap conduir?
I'll start this evening.	Començaré esta vesprada.
We have to go by the rules.	Hem de seguir les regles.
Have a good time on your date.	Passeu-vos-ho bé en la vostra cita.
Do you have any questions?	Alguna pregunta?
He lost his memory.	Va perdre la memòria.
She hates running.	Ella odia córrer.
That'll put you in danger.	Això et posarà en perill.
The rumor is true to some extent.	Fins a un cert punt, el rumor és cert.
Do you like this music?	T'agrada aquesta música?
Do you wish to go?	Et vols anar?
Nothing happens unless you make it happen.	No passa res si tu no fas que passi.
We are sorry for the inconvenience.	Ens sap greu la molèstia causada.
Who are you talking to?	Amb qui esteu parlant?
German is the best language in the world.	L'alemany és la millor llengua del món.
Will you show me your photo album?	Em mostraràs el vostre àlbum de fotos?
We walked three kilometers.	Vam caminar tres quilòmetres.
We saw you.	Vos vam vore.
Her book is red.	El seu llibre és roig.
I'm sure of winning the championship.	Estic segur de guanyar el campionat.
Take this medicine before each meal.	Preneu aquest medicament abans de cada àpat.
We have to act quickly.	Hem d'actuar ràpid.
Tom hates himself.	En Tom s'odia a ell mateix.
I don't know who painted this picture.	No sé qui va pintar aquest quadre.
According to a Gallup poll, 44% of Americans believe the world is less than 10,000 years old.	Segons una enquesta de Gallup, el 44% d'estatunidencs creu que el món té menys de 10.000 anys.
How long will this cold last?	Quant de temps durarà aquesta fred?
This cola has lost its fizz and doesn't taste any good.	Aquesta cola s'ha esbravat i no té bon gust.
They were satisfied.	Estaven cofois.
Mary is a feminist.	La María és feminista.
If you don't want to be alone, I can keep you company.	Si no vols estar sol, puc fer-te companyia.
He told me an interesting story.	M'ha contat una història interessant.
I know that Tom is a very clumsy guy.	Sé que el Tom és bastant maldestre.
I am a redhead.	Sóc pèl-roja.
I don't like it when you swear.	No m'agrada que digues paraulotes.
Do you wanna bet?	Apostes?
Most schools are closed today.	La majoria d'escoles avui estan tancades.
I'm busy, so I can't help.	Estic ocupat, no puc ajudar-te.
Tom only listens to podcasts.	En Tom només escolta podcasts.
Are you a policeman?	Ets policia?
The bullet penetrated his chest, leaving him in critical condition.	La bala va penetrar al seu pit i el va deixar en estat crític.
Everyone was listening very carefully.	Tots estaven escoltant atentament.
Where's Tom going to sleep?	On dormirà en Tom?
Is Flight 123 going to be delayed?	El vol 123, té retard?
Does he speak English?	Parla anglès?
I have something to tell you.	Us he de dir una cosa.
She sent me a letter.	Ella em va enviar una carta.
The class was divided into four groups.	La classe es va dividir en quatre grups.
I like listening to music.	M'agrada escoltar música.
Both men apologized to each other.	Tots dos homes es van disculpar entre ells.
We've talked it over among ourselves.	N'hem parlat entre nosaltres.
I paid him the money last week.	Li vaig pagar els diners la setmana passada.
I wonder whether Tom has a driver's license or not.	Em pregunto si en Tom té carnet de conduir o li manca.
We don't know why he had to leave.	No sabem per què va haver de marxar.
Tom looked ridiculous.	En Tom es veia ridícul.
I'd like to stay for one night.	M'agradaria quedar-me aquí una nit.
I want to learn how to ski.	Vull aprendre a esquiar.
You will miss the train.	Perdràs el tren.
He looks like his father.	Ell s'assembla al seu pare.
He told me not to tell lies.	Em va dir que no expliqués mentides.
Tom is too young to drive a car.	Tom és massa jove per portar un cotxe.
This eagle's wings are broken.	Les ales d'aquesta àguila estan trencades
His father died, and to make matters worse, his mother fell ill.	Son pare es va morir, i per acabar-ho d'adobar, sa mare es va posar malalta.
Tom used to cry a lot when he was a child.	Tom plorava molt quan era un xiquet.
It's dangerous to jump off a moving train.	És perillós saltar d'un tren en marxa.
I have a coat, but no hat.	Tinc un abric, però cap barret.
I'd like to give you something.	M'agradaria donar-te alguna cosa.
What is going on?	Què passa?
Tom couldn't hold back his tears.	Tom no podia contenir les llàgrimes.
This is a fish.	Açò és un peix.
Tom told everybody that he wanted to move to Boston.	En Tom va dir a tothom que es volia mudar a Boston.
Her explanation of the problem made no sense.	La seva explicació del problema no tenia ni cap ni peus.
Helen Keller was deaf and blind.	Hellen Keller era sorda i cega.
I don't have time to write.	No tinc temps per escriure.
It can wait until morning.	No puc esperar fins al matí.
I recognized him at first glance.	L'he reconegut a primer cop d'ull.
I am sure of his winning the tennis match.	Estic segur de la seva victòria al tennis.
I'm getting off the train at the next station.	Em baixo del tren a la pròxima estació.
I haven't been to work. I've stayed at home all day.	No he anat a treballar, m'he quedat a casa tot el día.
I had a light breakfast.	Vaig esmorzar lleuger.
Where will you be staying?	On et quedaràs?
I didn't pay Tom to do that.	Jo no vaig pagar el Tom per fer allò.
I never get tired of talking.	No em canso mai de parlar.
Do you want to go?	Et vols anar?
I imagine that you are wondering when your new PC will arrive.	Imagino que t'estàs preguntant quan arribarà el teu ordinador nou.
It's not so easy.	No és tan fàcil.
I got along with everybody.	Em portava bé amb tothom.
Does the bus stop here?	L'autobús para ací?
The urban population of America is increasing.	La població urbana a Amèrica està creixent.
Are you looking for work?	Busques feina?
She and I are the same age.	Ella i jo tenim la mateixa edat.
I like to listen to music.	M'agrada escoltar música.
We look ridiculous.	Ens veiem ridícules.
We want a lawyer.	Volem un advocat.
I've not been to work. I've stayed at home all day.	No he anat a treballar, m'he quedat a casa tot el día.
I'm not a teacher.	No soc professora.
Is there anything Tom won't do?	Hi ha res que el Tom no faci?
She explained the literal meaning of the phrase.	Va explicar el significat literal de la frase.
Are you happy?	Ets feliç?
France is in western Europe.	França és a l'Europa Occidental.
She's pregnant.	Està prenyada.
Tom is the captain of this baseball team.	Tom és el capità d'aquest equip de beisbol.
I don't have a cat.	No tinc cap gat.
Tom hates himself.	En Tom s'odia a si mateix.
Who is this letter from?	De qui és aquesta carta?
I'm sick. Will you send for a doctor?	Estic malalt. Oi que avisaràs un metge?
We're sorry for the inconvenience.	Ens sap greu la molèstia causada.
I don't want to read this book.	No vull llegir aquest llibre.
I want to see you.	Vull veure't.
Things are not that simple.	Les coses no són tan senzilles.
I'm surprised that he accepted the offer.	Em sorprèn que acceptés l'oferiment.
Do you know the boy who is crying over there?	Coneixes el noi que plora allà?
The tiger mosquito is one of the most common carriers of chikungunya and dengue.	El mosquit tigre és un dels portants més habituals del chikungunya o del dengue.
My friend doesn't believe that ghosts exist.	El meu amic no es creu que els fantastes existeixen.
When did that happen to you?	Quan us va passar allò?
When he was young, he would often watch baseball.	Quan ell era jove, veia sovint el beisbol.
What are you planning?	Què planeges?
It snowed from Monday to Friday.	Va nevar de dilluns a divendres.
I'd like to go home.	Vull anar a casa.
Tom leaves for work at 6:30 every morning.	En Tom surt a treballar cada matí a dos quarts de set.
Can you do anything to help Tom?	Pots fer res per ajudar el Tom?
There's something going on between Tom and Mary.	Alguna cosa hi ha entre el Tom i la Mary.
I ate the cheese.	Em vaig menjar el formatge.
I have no family.	No tinc família.
The evidence was against me.	L'evidència estava en contra meua.
That's exactly what happened.	Això és exactament el què va passar.
You don't have to do this.	No has de fer-ho.
There were a lot of things Tom didn't tell us about.	Hi havia un munt de coses de les quals en Tom no ens havia dit res.
I write letters that I never send.	Escric cartes que no envio mai.
He is the manager of a hotel.	És el director d'un hotel.
But what does this have to do with the birds?	Però, què té a veure, això, amb els ocells!
The situation is beyond my control.	La situació és més enllà del meu control.
I didn't know that you were finished doing that already.	No sabia que haguessis acabat de fer allò ja.
Who are you?	Qui ets?
It's very hot here.	Aquí fa molta calor.
When did you begin studying English?	Quan vas començar a estudiar anglès?
I had fun hanging out with Tom last weekend.	M'ho vaig passar bomba el cap de setmana passat quan vaig quedar amb en Tom.
Tell me your plans for the future.	Conta'm els teus plans de futur.
She sent you her best wishes.	Ella t'envia els seus millors desitjos.
Who are you with?	Amb qui esteu?
I'm looking for Tom. You haven't seen him, have you?	Estic buscant el Tom. L'heu vist?
They will not eat meat.	No menjaran carn.
Life has become very difficult.	La vida s'ha tornat molt difícil.
She admired him.	Ella l'admirava.
I write to my mother once a month.	Escric a la meva mare un cop al mes.
I have been studying French four years now.	Fa quatre anys que estudio francès.
We have a French exam on Monday.	Tenim un examen de Francès el dilluns.
Did you have a good time?	T'ho vas passar bé?
Are you hungry now?	Ara tens fam?
How many children do you have?	Quants fills tens?
Are you crying?	Estàs plorant?
I have cookies for breakfast every day.	Cada dia menjo galetes per esmorzar.
I'm a bit nervous.	Estic un poc nerviós.
Who let you come in?	Qui us ha deixat passar?
I will walk.	M'aniré caminant.
Are you asleep?	dorms?
Do you know who wrote this novel?	Sabeu qui va escriure aquesta novel·la?
It is said that golf is very popular in Japan.	Es diu que el golf és molt popular al Japó.
I planted an apple tree in my garden.	He plantat un pomer al meu jardí.
You don't have to kick yourself.	No et facis mala sang.
I have breakfast every morning.	Cada dia esmorzo.
Have you eaten breakfast yet?	Ja has esmorzat?
Do you have a smartphone?	Tens un mòbil?
Tom is no longer studying French.	En Tom ja no estudia francès.
He's better than us all.	Ell és millor que tots nosaltres.
Are you asleep?	dormiu?
That book is mine.	Aquell llibre és meu.
I wish I could buy that guitar.	Tant de bo poguera comprar eixa guitarra.
I was surprised Tom didn't need to do that.	Em va sorprendre que en Tom no necessités fer-ho.
It doesn't sound natural.	No sona natural.
They're my books.	Són els meus llibres.
We're not here to play or have fun.	No estem aquí per jugar ni per divertir-nos.
Can you do anything to help Tom?	Podeu ajudar el Tom d'alguna forma?
I ordered a pizza by phone.	Vaig demanar una pizza per telèfon.
Tom woke up when the telephone rang.	En Tom va despertar-se quan el telèfon va sonar.
As a student, I became interested in oriental languages.	Com a estudiant vaig interessar-me per les llengües orientals.
Tom may talk to Mary if he wants to.	Tom pot parlar amb Mary, si vol.
That house belongs to him.	Aquella casa li pertany.
I've got a question.	Tinc una pregunta.
Have a good time on your date.	Passa-t'ho bé en la teva cita.
"How are you feeling this morning?" "Pretty good, thanks."	"Com et sents aquest matí?" "Bastant bé, gràcies."
My children will come with me.	Els meus fills vindran amb mi.
Don't worry about me.	No et preocupis per mi.
Tell me your plans for the future.	Explica'm els teus plans per al futur.
I envy him.	L'envejo.
Put the chair near the window, please.	Posa la cadira prop de la finestra, si us plau.
I already said yes.	Ja he dit que sí.
Tom had acne when he was a teenager.	En Tom tenia acne quan era adolescent.
These are our books.	Són els nostres llibres.
I'm sorry to hear that.	Em sap greu escoltar això.
I'm disappointed with you.	M'has decebut.
Tom may talk to Mary if he wants to.	En Tom, si vol, pot parlar amb la Mary.
Who are you guys talking to?	Amb qui esteu parlant?
I think we'll go with you.	Crec que ens en anirem amb tu.
She hates carrots.	Ella odia les safanòries.
Tom noticed that Mary was having trouble breathing.	El Tom va notar que a la Mary li costava respirar.
My father died before I was born.	El meu pare va morir abans de néixer jo.
Drink your coffee before it gets cold.	Beu-te el cafè abans no se refredi.
Have you had dinner yet?	Ja heu sopat?
He fell and hurt his leg.	Ell es va caure i es va fer mal a la cama.
I asked him many questions about ecology.	Li vaig fer moltes preguntes sobre ecologia.
I'd like to give you the key, but I can't.	M'agradaria donar-te la clau, però no puc.
Your son is a genius.	El vostre fill és un geni.
Tom wants to come to Boston with us.	En Tom vol venir a Boston amb nosaltres.
We're not going to change anything.	No canviarem res.
I'd like to get married.	M'agradaria casar-me.
He went back home.	Ell va tornar a casa.
The new furniture arrived today.	El nou mobiliari ha arribat avui.
By the way, how old are you?	Per cert, quina edat tens?
I'll show you a few photos.	T'ensenyo un parell de fotos.
All men are mortal.	Tots els homes son mortals.
How much is this watch worth?	Quant val aquest rellotge?
Fire is always dangerous.	El foc sempre és perillós.
Why are you here?	Perquè estàs aquí?
Get out.	Surtiu.
Are you afraid of me?	Que tens por de mi?
I am going to do it whether you agree or not.	Ho faré, estigueu o no d'acord amb mi.
Shut up and listen.	Calla i escolta!
I'm so sorry for not writing to you for such a long time.	Em sap molt de greu haver estat tant de temps sense escriure't.
The lion is the king of the jungle.	El lleó és el rei de la selva.
You have to help her.	Heu d'ajudar-la.
He is getting better bit by bit.	Ell s'està millorant poc a poc
He lost all the money he had.	Va perdre tots els diners que tenia.
Hurry up.	Afanya't.
I study for 3 hours every day.	Jo estudio 3 hores cada dia.
The girl dressed in white is his fiancée.	La noia de blanc és la seva promesa.
The men are wearing short sleeve shirts.	Els homes porten camises de màniga curta.
The ground seems wet.	El sòl sembla mullat.
I know he likes jazz music.	Sé que li agrada el jazz.
Is rainwater drinkable?	Es pot beure l'aigua de la pluja?
I've put on a little weight.	He guanyat una mica de pes.
I refused to eat until my parents came home.	No vaig voler menjar fins que els meus pares no tornessin a casa.
I will ask him where he went last Sunday.	Li preguntaré on va anar el diumenge.
My father quit drinking.	El meu pare va aturar de beure.
They arrived late because of the storm.	Ells van arribar tard a causa de la tempesta.
We know that.	Ho sabem.
My brother-in-law is a policeman.	El meu cunyat és policia.
He doesn't look willing to come to the concert.	No sembla que vulgui venir al concert.
I think he has done it.	Crec que ell ho ha fet.
That's Tom.	Així és en Tom.
You still have to do that.	Encara tens que fer allò.
This is a fish.	Això és un peix.
Tom was afraid to die.	En Tom temia la mort.
You're taller than me.	Ets més alt que jo.
This is ridiculous.	Això és ridícul.
My dad died before I was born.	Mon pare va morir abans del meu naixement.
There's no reason to worry.	No hi ha cap motiu per preocupar-se.
Can you guys come here?	Que podeu venir aquí?
I was in the shower when the phone rang.	Estava en la dutxa quan ha sonat el telèfon.
I didn't have to tell Tom, but I did.	No li ho havia de dir per força, a en Tom, però ho vaig fer.
I have problems communicating in French.	Tinc problemes comunicant-me en francès.
Shut up and listen!	Calla i escolta!
I burned my fingers on a hot iron.	Em vaig cremar els dits amb una planxa calenta.
It's very symbolic.	És molt simbòlica.
Congratulations!	L'enhorabona!
I didn't know you'd come back.	No sabia que tornaries.
Why does racism still exist?	Per què encara existeix el racisme?
We're vegans.	Nosaltres som vegans
How about if we go play golf this afternoon?	Què tal si anem a jugar a golf aquesta tarda?
He was willing to work for others.	Ell estava disposat a treballar per altres.
Are you free this weekend?	Estàs lliure este cap de setmana?
My hobby is listening to music.	El meu hobby és escoltar música.
I'm not interested in going to the baseball game.	No tinc cap interès a anar al partit de beisbol.
Are you finished?	Has acabat?
What's happening tonight?	Què passa aquesta nit?
Tom was in Boston at the time.	En aquell moment en Tom era a Boston.
The boy asked his mother a question.	El nen li feu una pregunta a la seva mare.
The water was warm.	L'aigua estava calenta.
Don't compare me to a movie star.	No em comparis amb una estrella de cinema.
I also kissed Tom.	Jo també vaig petonejar en Tom.
Those are our books.	Són els nostres llibres.
What's your favorite podcast?	Quin és el teu podcast preferit?
What's the problem?	Quin problema hi ha?
Are you hungry now?	Tens fam, ara?
There are purple tulips next to my castle's windows.	Hi ha tulipes de color violeta al costat de les finestres del meu castell.
Tom goes to Boston every once in a while.	En Tom va a Boston de tant en tant.
Are we talking about the same Tom?	Parlem del mateix Tom?
Your opinion is important to me.	La teua opinió és important per a mi.
Tom used to work in Australia.	En Tom treballava a Australia.
How long have you had a headache?	Fa quant de temps que et fa mal el cap?
It's even worse than it looks.	És fins i tot pitjor del que es veu.
I'm very glad to see you again.	Estic molt content de tornar-te a veure.
I burned my fingers on a hot iron.	Em vaig cremar els dits amb un ferro roent.
Who built the snowman?	Qui ha fet el ninot de neu?
By the age of 25, she had lived in five different countries.	Als 25 anys, ella havia viscut a cinc països diferents.
I can't remember which is my racket.	No recorde quina és la meua raqueta.
Who let you come in?	Qui t'ha deixat entrar?
Don't you get bored when you're alone?	No s'avorreix quan està sol?
No one knows what tomorrow has in store.	Ningú no sap què ens brinda el demà.
She makes him do his homework before dinner.	Ella l'obliga a fer els deures abans de sopar.
Is that a bear?	És aquest un os?
I can see the light.	Puc veure la llum.
She raised her hand.	Ella va alçar la mà.
I've always dreamed of opening a restaurant.	Sempre he somiat amb obrir un restaurant.
Maybe Tom asked Mary to lie.	Potser el Tom li va demanar a la Mary que mentís.
Racism is still with us.	El racisme encara hi és amb nosaltres.
I made a careless mistake.	Vaig cometre una negligència.
You're everything to me.	Tu ets tot per mi.
Why don't you guys stay for a bit?	Us quedeu una estona?
I don't speak French or German.	No parlo ni francès ni alemany.
Aren't you ever coming back?	Que no tornaràs mai?
Tom isn't hungry.	Tom no té fam.
What language do you think in?	En quina llengua penses?
I don't know if he knows it.	No sé si ho sap.
I like to walk.	M'agrada caminar.
Tom works in a coffee shop.	En Tom treballa en una cafeteria.
Tom and Mary acted like children.	En Tom i la Mary es portaven com nens.
I have an earache.	Tinc otitis.
We're not tired.	No ens hem cansat.
Wait.	Espera't.
Tom will likely be the first person to leave.	El Tom serà probablement el primer a marxar.
A lot of jobs are done by computers.	Moltes feines les fan els ordinadors.
Let me try it.	Deixa'm intentar-ho.
Tom didn't think Mary would be so careless.	En Tom no es pensava que la Maria passaria tant de tot.
Tom couldn't hold back his tears.	Tom no va poder contenir les llàgrimes.
My apartment is on the fourth floor.	El meu apartament està al quart pis.
I want to stay here.	Vull quedar-me aquí.
He looked very happy.	Ell semblava molt feliç.
I spend money as soon as I get it.	Em gasto els diners de seguida que en tinc.
Everyone hoped that she would win.	Tothom esperava que guanyés.
Tom and Mary love each other.	En Tom i la Maria s'estimen l'un a l'altra.
It's really annoying.	És realment molest.
They insisted on my making use of the opportunity.	Em varen insistir per a que aprofitès aquella oportunitat.
Tom warned Mary about John.	En Tom advertí la Maria d'en Joan.
I don't know how much longer I'll be able to stand this.	No sé quant més de temps podré suportar això.
There are many beautiful parks in London.	A Londres hi han molts parcs bonics.
Please circle the right answer.	Encercleu la resposta correcta, sisplau.
I'd like to find somebody to talk to.	M'agradaria trobar algú amb qui poder xerrar.
Here is your bag.	Aquí és la teva bossa.
It seems I'm going to be up all night tonight.	Sembla que avui estaré despert tota la nit.
Tom is hoping that everybody will leave, so he can go to bed.	En Tom espera que tothom marxi per poder anar a dormir.
Tom still plays the violin, doesn't he?	En Tom encara toca el violí, oi?
Bats scare me.	Em fan por els ratpenats.
What a beautiful sunset.	Quina posta de sol més bonica.
Are you brushing your teeth properly?	T'estàs raspallant bé les dents?
Please send us more information.	Sisplau, mandi'ns més informació.
All the apples that fall are eaten by the pigs.	Totes les pomes que en cauen se les mengen els porcs.
Which is larger, the sun or the earth?	Quin és més gran: el Sol o la Terra?
Is there a post office around here?	Hi ha alguna oficina de correus prop d'ací?
He will be free tomorrow.	Demà sirà lliure.
A man who never makes mistakes is a man who does nothing.	Qui no fa res malament, no fa res.
Can your mom drive a car?	La vostra mare sap conduir?
Tom is young, but he knows what he's doing.	El Tom és jove, però sap el que està fent.
I'd like to get you both to help me.	M'agradaria que ambdós m'ajudéssiu.
He went skiing during the winter.	Se'n va anar a esquiar a l'hivern.
My friend has had three jobs in a year; he never sticks to anything for long.	El meu amic ha treballat a tres llocs diferents en un any; res no li dura gaire.
Would you like to go?	Et vols anar?
The photo was a hoax.	La foto era un bluf.
I'm the one who pays all the bills.	Jo sóc qui paga totes les factures.
Tom was discharged today.	Al Tom l'han donat d'alta avui.
Tom wasn't sure where he should go.	En Tom no estava segur d'on hauria d'anar.
Tom doesn't drive to work.	En Tom no condueix a la feina.
He speaks five languages.	Ell parla cinc idiomes.
Who are you?	Qui sou?
Where will you be staying?	On t'allotjaràs?
Racism today isn't so overt.	El racisme avui dia encara no ha acabat.
I'm looking for Tom. You haven't seen him, have you?	Estic buscant el Tom. L'has vist?
Ten years is a long time to wait.	10 anys és un llarg temps per esperar.
I have something to tell you.	Tinc una cosa a dir-te.
I'll make an exception just this once.	Faré una excepció només per aquesta vegada.
I'm a vegan.	Jo sóc vegà
The bus arrived ten minutes late.	L'autobús arribà deu minuts tard.
I'm sorry, but I can't find the book you lent me.	Em sap greu, però no trobo el llibre que em vas deixar.
My son has gone to America to study medicine.	El meu fill ha anat a Amèrica a estudiar medicina.
Tom told me the good news.	En Tom m'ha dit la bona nova.
Is there a post office around here?	Hi ha alguna oficina postal per aquí?
Only peace can save the world.	Només la pau pot salvar el món.
Can we spend the night in that hotel?	Podem passar la nit en aquell hotel.
I'm glad you're here.	M'alegra que estigueu ací.
Tom likes Indian food.	A en Tom li agrada el menjar indi.
What are you going to eat for dinner?	Que soparàs avui?
Only adults are allowed to do that.	Només els adults tenen permís per fer allò.
Tom was fired for a good reason.	Tom va ser despedit per una causa justa.
His courage is worthy of high praise.	La seva valentia mereix grans lloances.
They got off the bus.	Ells van baixar de l'autobús.
I'm looking for Tom. You haven't seen him, have you?	Busco el Tom, no l'has vist pas?
Tom was walking in front of Mary.	El Tom caminava davant la Mary.
I heard a beautiful song yesterday.	Ahir vaig sentir una cançó bonica.
Tom doesn't watch TV.	En Tom no mira la tele.
Tom is calling from his cellphone.	En Tom truca des del seu telèfon mòbil.
I'd like to go home now.	Vull anar a casa ara.
That bottle is full.	Aquella ampolla és plena.
Where will Tom sleep?	On dormirà en Tom?
Why is snow white?	Per què és blanca la neu?
We've all been there.	Tots hi hem estat, allà.
He comes here every five days.	Ve aquí cada cinc dies.
He must have reached the station.	Ell deu haver arribar a l'estació.
That's a beautiful dress.	Aqueix és un vestit preciós.
The photo was a hoax.	La foto era una enganyifa.
The price reflects the demand.	El preu reflexa la demanda.
Don't you have work today?	Avui no tens feina?
I'm pretty tired today.	Hui estic ben cansada.
Are you going to save us?	Que ens salvareu?
I can't stand that noise.	No puc aguantar aquest soroll.
I love you.	T'estimo.
We must follow the rules.	Hem de seguir les regles.
That's ridiculous.	Allò és ridícul.
I'm standing in the shade.	M'estic dret a l'ombra.
The bird's wing was broken.	El pardal tenia una ala trencada.
They're my guests.	Són els meus convidats.
Do you have a camera?	Tens càmera fotogràfica?
I think Tom is reliable.	Em penso que en Tom és confiable.
You guys have never been to Europe, right?	No heu estat mai a Europa, oi?
I'd like to go back to the office.	M'agradaria tornar a la oficina.
That's ridiculous!	Allò és ridícul!
Here is your bag.	Ací tens la teua bossa.
That's a bright idea.	És una idea brillant.
What do these dots represent on the map?	Què signifiquen aquests punts al mapa?
The bus arrived ten minutes late.	El bus va arribar deu minuts tard.
She helped me willingly.	Ella em va ajudar de bon gust.
Why is fishing not permitted here?	Per què està prohibit pescar ací?
The cows looked big and docile.	Les vaques semblaven grans i dòcils.
I'll be back in ten minutes.	Tornaré en deu minuts.
He is a clever boy.	És un noi despert.
Thinking is talking with oneself.	Pensar és parlar amb un mateix.
Nobody equals him in strength.	Ningú no li és rival.
What's your secret?	Quin és el teu secret?
She tried to squeeze the juice out of the orange.	Va provar d'escórrer la taronja.
I'm already late.	Ja faig tard.
Switzerland is a beautiful country.	Suïssa és un país molt bonic.
The sun gives us heat and light.	El Sol ens dóna calor i llum.
Who has a question?	Algú té alguna pregunta?
These questions are easy to answer.	Aquestes preguntes són fàcils de respondre.
The bicycle is mine.	La bicicleta és meva.
Tom will likely be the first person to leave.	El Tom serà gairebé segur el primer a marxar.
I can't remember where I bought it.	No recorde on el vaig comprar.
She stood up.	Ella es va aixecar.
He wants a watch like yours.	Vol un rellotge com el teu.
Tom took out a pen and a notepad.	En Tom va treure un bolígraf i un bloc de notes.
Mr. Jackson was my worst teacher in high school.	Mr. Jackson va ser el meu pitjor professor de l'institut.
Please write to me from time to time.	Escriu-me de tant en tant, sí?
Can I ask some questions?	Puc fer unes preguntes?
Shall we go to the beach?	Anem a la platja?
Tom was too frightened to do that.	En Tom estava massa esgarrifat per a fer allò.
Are you asleep?	t'has adormit?
Tom wants to be famous.	Tom vol ser famós.
Things don't change very quickly around here.	Les coses no canvien gaire ràpid per aquests volts.
Let go of my arm.	Deixa'm anar el braç.
I have a problem.	Tinc un problema.
There's a dictionary on the table.	Hi ha un diccionari a la taula.
Don't leave the door open.	No deixeu la porta oberta.
It's always been like that.	Sempre ha sigut així.
He explained the literal meaning of the sentence.	Va explicar el significat literal de la frase.
Are you asleep?	us heu adormit?
Tom said that you were going to Boston.	El Tom va dir que anaves a Boston.
You treated me like a little kid.	Em vas tractar com a un nen petit.
Go to sleep, Tom.	Ves a dormir, Tom
I'm 17, too.	Jo també tinc 17 anys.
Everybody loves him.	Tots l'estimen.
This is ridiculous!	Això és ridícul!
Tom lacks courage.	A en Tom li falta coratge.
It's nice and cool here.	Aquí fa fresca i s'hi està bé.
I'm glad you're here.	M'alegra que estigues ací.
I'm looking for Tom. You haven't seen him, have you?	Busco el Tom, no l'heu vist pas?
I have something to tell you.	T'he de dir una cosa.
We need help.	Necessitem ajuda.
Let me know when he will arrive.	Ja em diràs quan arriba.
Which do you think is best?	Quina creus que és millor?
Tom can't swim.	En Tom no sap nedar.
I don't want to do that for Tom.	No vull fer-ho per a en Tom.
Have you had breakfast?	Ja has esmorzat?
They live on the other side of the river.	Viuen a l'altra banda del riu.
What really happened to us?	Què ens va passar realment?
Those are empty words.	Són paraules buides.
I didn't buy this book.	No vaig comprar aquest llibre.
We love you.	Us estimem.
The earth is much larger than the moon.	La Terra és molt més gran que la Lluna.
I felt that I needed to do something.	Vaig sentir la necessitat de fer alguna cosa.
You said that the other day, right?	Això vas dir l'altre día, no?
You can stay here tonight.	Pots passar la nit aquí.
This swallow's wings are broken.	Les ales d'aquesta oroneta estan trencades.
Use your fist.	Fes servir el teu puny.
5 is less than 8.	5 són menys que 8.
Tom chickened out.	En Tom es va cagar.
Tom's father is older than Mary's.	El pare d'en Tom és més gran que el de la Mary.
They arrived in America a few days ago.	Van arribar a Amèrica fa uns quants dies.
We may be late for school.	Potser farem tard a l'escola.
Gold's heavier than iron.	L'or és més pesat que el ferro.
I was glad to see that he finally came to his senses.	Vaig estar content de veure que al final va posar-hi seny.
There's only one shop that sells this book.	Només hi ha una botiga que vengui aquest llibre.
Tom looks ridiculous.	En Tom es veu ridícul.
I'd like to go to the movies with you.	M'agradaria anar al cinema amb tu.
Which do you think is best?	Quin creus que és millor?
I just want you to leave me alone.	Només vull que em deixis en pau.
I like both.	M'agraden ambdós.
Tom ran out of money.	En Tom es va quedar sense calés.
Have you had your dinner?	Ja heu sopat?
Is that your bicycle?	Esta és la teua bicicleta?
We joined in the discussion.	Hem participat a la discussió.
Thank you for the other day.	Gràcies per l'altre dia.
I want to talk to Tom now.	Vull parlar amb en Tom ara mateix.
Tom's cat disappeared for a few days.	El gat d'en Tom va desaparèixer uns quants dies.
They hated Tom.	Odiaven en Tom.
I wanted to buy the book, but I found I had no more than 200 yen with me.	Volia comprar el llibre, però vaig adonar-me que no duia més de 200 iens.
Can your mom drive a car?	La teva mama sap conduir?
I shall sleep with your letter under my pillow tonight.	Hauria de dormir amb la teva carta sota el meu coixí aquesta nit.
I never realized that you were such a good French speaker.	No m'havia adonat que parles el francès tan bé.
Tom does everything he can to save money.	En Tom fa tot el que pot per estalviar.
It was always like that.	Sempre ha sigut així.
It was cheaper than I thought.	És més barat del que em vaig pensar.
My father retired at 65 years old.	Mon pare es va jubilar als 65 anys.
I didn't realize that you didn't know how to speak French.	No m'havia adonat que no parles francès.
Do you know where she's gone?	Saps on ha anat ella?
Any questions?	Alguna pregunta?
I'm afraid I caught a cold.	Em sembla que he agafat un constipat.
I'm sorry for yelling at you yesterday.	Em sap greu haver-te xisclat ahir.
Goodbye!	Adéu!
I saw the moon above the horizon.	Veig la lluna sobre l'horitzont.
Cuzco is one of the most interesting places in the world.	Cuzco és un dels indrets més interessants del món.
Why don't we see if Tom wants to play cards with us?	Perquè no mirem si en Tom vol jugar a les cartes amb niosaltres?
The majority of the population of this country are against mandatory voting.	La majoria de la població d'este país està en contra del vot obligatori.
Many people eat three meals a day.	Molta gent menja tres àpats al dia.
I've checked.	Ho he comprovat.
This is a very common injury.	Aquesta lesió és molt comú.
Hi, everybody.	Hola a tots.
Are you coming with us?	Vens amb nosaltres?
Tom may not be able to pay his rent next month.	Potser que el Tom no pugui pagar el lloguer del mes que ve.
This book is missing two pages.	A aquest llibre li falten dues pàgines.
My life would be so different now if I hadn't done that.	La meva vida seria tan diferent ara mateix si no hagués fet allò.
We're going to leave tomorrow morning.	Sortirem demà al dematí.
Does your mother know?	Ho sap la teua mare?
I'd like to get to know Tom better.	M'agradaria conèixer millor en Tom.
Why are you not allowed to fish in this river?	Per què està prohibit pescar en este riu?
This medicine must not be placed within the reach of children.	Aquest medicament no s'ha de deixar a la ma dels nins.
I don't want to go on my own.	No vull anar-hi tot sol.
Brad Pitt is an actor.	El Brad Pitt és un actor.
Are you going out?	Sortireu?
My mother is always busy.	La meva mare sempre està ocupada.
Have you had breakfast yet?	Ja has esmorzat?
I'd rather do it by myself.	Prefereixo fer-lo pel meu compte.
He will take over the business when his father retires.	Ell continuarà el negoci quan son pare es jubili.
Unfortunately, my birthday is only once a year.	Malauradament, el meu aniversario només succeeix una vegada a l'any.
Thanks.	Gràcies!
I'm sure of his success.	Estic segur del seu èxit.
Get out!	Surtiu.
I'd like to have a little talk with you.	M'agradaria parlar una mica amb tu.
I eat a boiled egg for breakfast every day.	Cada dia em menjo un ou dur per esmorzar.
Are you falling for Tom?	T'estàs penjant d'en Tomàs?
He had a queer expression on his face.	Ell lluïa un visatge estrany.
I started a new book yesterday.	Ahir em vaig començar un llibre nou.
How many people are there in your family?	Quants són a la seva família?
Come along with me.	Acompanya'm.
Do you know which deity this temple is dedicated to?	Sabeu a quina divinitat està dedicat aquest temple?
My mother likes tulips very much and so does my sister.	A ma mare li agraden molt les tulipes i a ma germana també.
I think we'll go with you.	Crec que hi anirem amb tu.
The ticket you've bought isn't valid for travel during rush hour.	El billet que has comprat no és vàlid per a viatjar en hora punta.
You told her that you had finished the work three days before.	Li vas dir que havies enllestit la feina feia tres dies.
How is anyone ever going to find us here?	Com redimonis ens podrà trobar algú aquí?
I agree.	Hi estic d'acord.
Tom should tell Mary not to forget to water the flowers.	El Tom li hauria de dir a la Mary que no oblidi regar les flors.
They don't seem happy.	No semblen feliços.
Tom is much taller than I expected.	El Tom és molt més alt del que m'esperava.
I drank all my milk.	Vaig beure'm tota la meva llet.
We're watching TV.	Estem mirant la televisió.
Can you all come here?	Que podeu venir aquí?
You agree with Tom, right?	Esteu d'acord amb Tom, veritat?
I've forgotten his name.	He oblidat el seu nom.
Tom is younger than all of his friends.	En Tom és més jove que la resta dels seus amics.
I'm not a doctor.	Jo no sóc metge.
I'm very full.	Estic molt tip.
I'm the one who takes out the garbage.	Jo sóc qui treu les escombraries.
I made Tom wait.	He fet esperar en Tom
Do it by all means.	Fes-ho com sigui.
Can you do anything to help Tom?	Podeu fer res per ajudar el Tom?
Both of them are unpredictable and impatient.	Tots dos són impredictibles i impacients.
She has a white cat.	Ella té un gat blanc.
I don't think Tom was talking about me.	No crec que Tom estigués parlant de mi.
Are you coming in or not?	Entres o no?
The bird's wing was broken.	L'ala de l'ocell estava trencada.
Tom's parents were missionaries in Africa.	Els pares d'en Tom eren missioners a l'Àfrica.
Everybody laughed.	Tothom rigué.
You're a good boy.	Ets un bon noi.
Make a wish.	Demana un desig
It's all you can really do.	És tot el que pots fer.
The Maori language is spoken in New Zealand.	La llengua maori es parla a Nova Zelanda.
I listened to her story.	Vaig escoltar la història d'ella.
A detective arrived at the crime scene.	Un detectiu va arribar a l'escena del crim.
Tom and Mary love each other.	En Tom i la Maria s'estimen l'una a l'altre.
In general, men are taller than women.	En general, els homes són més alts que les dones.
What's the name of your favorite restaurant?	Com es diu el teu restaurant preferit?
The bus arrived ten minutes late.	L'autobús va arribar amb deu minuts de retard.
Tom enjoyed playing baseball.	En Tom gaudia de jugar a bèisbol.
The bird's wing was broken.	L'ocell tenia una ala trencada.
Gold is heavier than iron.	L'or és més pesat que el ferro.
I will take you to the zoo one of these days.	Un dia d'aquests et portaré al zoo.
She didn't tell me her secret.	Ella no em va dir el seu secret.
Tom said that Mary has only done that once.	El Tom digué que la Mary ho havia fet només una vegada.
It is free of charge.	És gratuït.
There's just too much to do.	Senzillament hi ha tant a fer.
Tom knows time's running out.	El Tom sap que el temps s'acaba.
I'd like to meet your older sister.	Voldria trobar-me amb la teva germana gran.
Tom has a podcast.	En Tom té un podcast.
Who are you all?	Qui sou tots vosaltres?
She dumped him for a richer man.	Ella va abandonar-lo per un home més ric.
I know these students.	conec aquests estudiants.
We're not going anywhere.	No anem enlloc.
Come whenever you like.	Veniu quan vulgueu.
I went to Vienna for the first time last year.	L'any passat vaig anar a Viena per primer cop.
You have no idea how many times I've heard that.	No tens ni idea dels cops que he sentit això.
The sun is larger than the moon.	El Sol és més gran que la Lluna.
Did you have breakfast?	Ja has esmorzat?
Tom always says that.	Tom sempre diu això.
Can I help?	Puc ajudar?
It's not difficult.	No és pas difícil.
We have two daughters.	Tenim dues filles.
Do it by all means.	Fes-ho peti qui peti.
The crowd rushed to the exit.	La gentada va córrer cap a la sortida.
The protestors accused the police of abuse.	Els manifestants van acusar a la policia d'abús.
Tom is younger than all his friends.	En Tom és més jove que la resta dels seus amics.
He knows how to swim.	Ell sap nedar.
The leaves fell from the trees.	Les fulles caigueren dels arbres.
Tom doesn't go to school anymore.	Tom ja no va a l'escola.
I haven't done that since I was twelve.	No ho he fet des que tenia dotze anys.
What is wrong with that guy?	Què li passa a aquet paio?
I wasn't asking that.	No he preguntat això.
I have a friend whose father is a famous pianist.	Tinc un amic el pare del qual és un pianista famós.
Have you already eaten dinner?	Ja heu sopat?
My dog has a very long tail.	El meu gos té una cua molt llarga.
Tell me your plans for the future.	Expliqueu-me els vostres plans per al futur.
I'm always hungry.	Sempre tinc gana.
Where will you be staying?	On us allotjareu?
What would it cost to have this chair repaired?	Quant costaria arreglar aquesta cadira?
We have a lot of fun.	Ens divertim molt.
I'd like to meet your older sister.	M'agradaria conèixer la teva germana gran.
I made my son a new suit.	He fet un vestit nou per a mon fill.
Do you have medical insurance?	Teniu assegurança mèdica?
Is he still here?	Ell encara es aquí?
I don't know her address.	No sé la seva adreça.
She's pregnant.	Ella està prenyada.
Tom was told not to wait.	Al Tom li van dir que no s'esperés.
I'd like to know when you can send it out.	M'agadaria saber quan ho pot enviar.
Do you have a cell phone?	Tens un mòbil?
It was a nightmare.	Va ser un malson.
I was the one who knocked on the door.	Vaig ser jo qui va trucar a la porta.
He'll return at six.	Tornarà a les sis.
Japan imports a large quantity of oil.	El Japó importa una gran quantitat de petroli.
I don't want to sleep on the couch again tonight.	No vull dormir al sofà de nou aquesta nit.
Fishing in this lake is prohibited.	Està prohibit pescar en aquest llac.
My husband and daughter are fast asleep.	El meu marit i la meva filla dormen com un soc.
Tom and I are good friends now, but we didn't like each other at first.	En Tom i jo som bons amics ara, però al principi no ens quèiem gaire bé l'un a l'altre.
A can of beer tastes better after a hard day's work.	Una llauna de cervesa fa més bon gust després d'un dia de treballar de valent.
Go to sleep, Tom.	A dormir, Tom.
I want to meet you.	Vull veure't.
I don't know for certain when he will come.	No sé del cert quan vindrà.
I like white roses more than red ones.	M'agraden més les roses blanques que les vermelles.
Tom writes books.	En Tom escriu llibres.
I have a sore throat.	Tinc mal de coll.
How long have you been here?	Quant de temps us heu estat aquí?
Music surrounds our lives like air.	La música envolta les nostres vides com ho fa l'aire.
He and his sisters are currently living in Tokyo.	En aquest moment, ell i les seves germanes viuen a Tòquio.
He helped poor people all his life.	Ell va ajudar els pobres tota la seva vida.
You can trust him.	Pots confiar en ell.
Have you eaten supper yet?	Ja heu sopat?
I called my attorney.	Vaig trucar el meu advocat.
I can't remember where I bought it.	No recorde on la vaig comprar.
Please wash your hands properly before eating.	Siusplau renteu-vos les mans com cal abans de menjar.
Is this book yours?	Aquest llibre és teu?
The policewoman directed traffic.	L'agent de policia dirigia el trànsit.
Asians generally have black hair.	Els asiàtics normalment tenen el cabell negre,
The door is locked at nine o'clock.	La porta es tanca amb clau a les nou.
This is extremely hard for Tom.	Això és extremadament difícil per a en Tom.
Wait here till he comes back.	Espera aquí fins que ell torni.
The Japanese economy developed rapidly.	L'economia japonesa es va desenvolupar depressa.
Tom doesn't like how Mary laughs.	A en Tomàs no li agrada com riu la Maria.
I'm not sure when Tom will come back.	No estic segur de quan tornarà Tom.
I'd like to get a head start.	M'agradaria tenir-hi avantatge inicial.
Turn down the TV, please.	Baixa el volum del televisor.
Dogs bark and birds tweet.	Els gossos borden i les aus piulen.
You must have a lot of patience to learn foreign languages.	Cal molta paciència per a aprendre llengües foranes.
Birds fly in the sky.	Els ocells volen pel cel.
How much money does he make a month?	Quant guanya al mes?
I didn't suspect anything.	No vaig sospitar res.
What's inside the box?	Què hi ha dins la caixa?
I never realized that you were such a good French speaker.	Mai havia notat que parlessis el francès tan bé.
Please answer the question again.	Si us plau respongui un altre cop a la pregunta.
I must have the wrong number.	Dec tenir el número equivocat.
Is it going to snow tonight?	Què nevarà avui al vespre?
Who are you with?	Amb qui estàs?
I like pizza with pineapple.	M'agrada la pizza amb pinya.
I want to break up with you.	Vull tallar amb tu.
I don't like it when you swear.	No m'agrada que digueu paraulotes.
I can't remember where I bought it.	No me'n recorde d'on ho vaig comprar.
Don't you think you can help Tom with that?	No creus que pots ajudar en Tom amb això?
She cried and cried, but nobody came to comfort her.	Ella plorava i plorava, però ningú no vingué a consolar-la.
Have a good weekend!	Bon cap de setmana!
How many letters are there in the alphabet?	Quantes lletres té l'abecedari?
What's inside the box?	Què hi ha a la caixa?
It is dangerous to cross that old bridge.	És perillós creuar aquell pont vell.
Whose are they?	De qui són?
Have a good time on your date.	Passi-ho bé a la seva cita.
Are there any questions?	Hi ha preguntes?
Three were sentenced to life in prison.	Es va sentenciar amb cadena perpètua a tres persones.
I can repeat it again and again.	Puc repetir-ho vint vegades.
I'm hoping to put an end to our unhappy relationship.	Friso per posar punt i final a la nostra relació infeliç.
I was surprised that Tom didn't need to do that.	Em va sorprendre que en Tom no necessités fer-ho.
The only useful answers are those that raise new questions.	Les úniques respostes útils són les que creen noves preguntes.
My mom yells at me all the time for no reason.	Ma mare m'escridassa tothora sense motiu.
Tom is probably not the tallest person in the room.	En Tom probablement no és la persona més alta en aquesta sala.
I started a new book yesterday.	Ahir vaig començar un llibre nou.
Tom is a silly man.	En tom és un ximplet.
I'm getting off the train at the next stop.	Em baixo del tren a la pròxima estació.
Thanks a lot for the invitation.	Moltes gràcies per la invitació.
We lost our way, and what was worse, we were caught in a shower.	Ens vam perdre i, encara pitjor, ens va enxampar un xàfec.
I need a stamp.	Necessito un segell.
Hope hasn't died.	Espero que no hagi mort.
Tom might still be there.	En Tom encara podria ser allà.
It was an easy win.	Va ser una victòria fàcil.
I'd like to go to the mall.	M'agradaria anar al centre comercial.
You should eat slower.	Has de menjar més a poc a poc.
I waited over a week.	Vaig esperar més d'una setmana.
Are you expecting Tom?	Esperes en Tomàs?
There are billions of stars in the sky.	Hi ha mil milions d'estels al cel.
Are you asking me on a date?	M'estàs proposant una cita?
Tom always drives too fast.	En Tom sempre condueix massa ràpid.
What did Tom ask you for?	Què t'ha demanat en Tom?
Did you enjoy reading this book?	Has gaudit llegint el llibre?
I'll start this evening.	Començaré aquest vespre.
I'd like to give it to Tom.	M'agradaria donar-li-ho a en Tom.
She's worried since she hasn't heard from her son for many months.	Està amoïnada perquè fa mesos que no té notícia del seu fill.
I want to get a tattoo.	Em vull tatuar.
I'll call him later.	Li cridaré més tard.
The flood caused a lot of damage.	La riada va fer molt de mal.
Why don't you sit down, and we'll have a drink together?	Per què no seus i bevem junts una copa?
I don't want to go to school.	No vull anar a l'escola.
It's important to condemn racism, but that alone isn't enough.	És important condemnar el racisme, però amb això no n'hi ha prou.
Do you have a cellphone?	Tens un mòbil?
She will have a baby next month.	Ella vol tenir un fill el mes vinent.
Tom got escorted off the plane.	Van escortar el Tom fora de l'avió.
I was warned about this.	Hom me'n va advertir.
I don't know exactly when I'll be back.	No sé exactament quan tornaré a ser aquí.
I'll let Tom know that you want to see him.	Faré saber a en Tom que vols veure'l.
My father died before I was born.	Mon pare va morir abans del meu naixement.
You look good.	Fas bon aspecte.
I'm talking on the phone.	Estic parlant per telèfon.
I'd like to have a few minutes alone with Tom.	Voldria tenir uns minuts a soles amb el Tom.
She buys what she wants regardless of the cost.	Compra el que vol sense fixar-se en el que val.
The sun appeared on the horizon.	El sol aparegué a l'horitzó.
In any case, this has nothing to do with you.	En tot cas, açò no té res a veure amb tu.
Have you seen her?	L'has vista?
I'm on my way to Tom's.	Estic de camí a can Tom.
Is there a post office around here?	Hi ha per ací alguna oficina de correus?
I think he did it.	Crec que ho va fer ell.
She hates carrots.	Ella odia les carrotes.
Two pages are missing from this book.	A aquest llibre li falten dues pàgines.
Don't go to sleep with the light on.	No et durmis amb el llum encès.
She sang better than him.	Ella va cantar millor que ell.
Tom is ridiculous.	En Tom és ridícul.
She raised her hand.	Va alçar la mà.
I don't understand what you're trying to say.	No entenc el que vols dir.
He is one of the candidates running for mayor.	És un dels candidats que es presenta per alcalde.
You agree with Tom, right?	Estàs d'acord amb Tom, oi?
Do you know who wrote this novel?	Saps qui va escriure aquesta novela?
Who let you come in?	Qui us ha deixat entrar?
Please don't open the window.	Si us plau, no obri la finestra.
I called my attorney.	Vaig trucar la meva advocada.
Are you falling for me?	T'estàs penjant de mi?
I want to make sure we have enough water.	Em vull assegurar que tenim prou aigua.
Have you eaten dinner yet?	Ja heu sopat?
I have two daughters.	Tinc dues filles.
We want a peaceful solution.	Volem una solució pacífica.
I think you might have trouble doing that.	Crec que tindràs problemes per fer allò.
I don't want to waste a moment more.	No vull perdre un instant més.
She says she brushes her teeth every morning.	Ella diu que es raspatlla les dents tots els dematins.
Does he speak English?	Que parla anglès, ell?
Have you had dinner?	Ja heu sopat?
I haven't got the nerve to ask you for a loan.	No tinc valor per demanar-te un préstec.
In the beginning God created the heaven and the earth.	Al principi Déu creà el cel i la terra.
I'd like to have a little talk with you.	M'agradaria xerrar una mica amb tu.
Stay out of my way.	Fora del meu camí!
This is the place where my father was born.	Aquest és el lloc on va nèixer el meu pare.
She saved a hundred dollars.	Ella es va estalviar cent dòlars.
I suspected that he was telling a lie, but that didn't surprise me.	Sospitava que m'estava dient una mentida, però això no em va sorprendre.
I wrote a cookbook.	Vaig escriure un llibre de cuina.
I feel like telling him what I think of him.	Tinc ganes de dir-li què penso d'ell.
About how long does it take to do that?	Quant dura fer allò més o menys?
We love you.	T'estimem.
What a beautiful sunset.	Quina posta més maca!
I have black eyes.	Tinc els ulls negres.
This river's water is clean.	L'aigua d'aquest riu està neta.
Tom says he's never owned a car.	El Tom diu que mai ha tingut un cotxe.
A lot of people died in that accident.	Molta gent va morir en aquell accident.
Everyone thinks the same thing.	Tothom pensa la mateixa cosa.
Where is he?	On és?
Have you already eaten breakfast?	Ja has esmorzat?
He never fails to write to his mother every week.	No passa una setmana que no li escrigui a la seva mare.
What's your opinion of Japanese food?	Quina és la teva opinió sobre el menjar japonès?
We're gonna make sure that no one is taking advantage of the American people for their own short-term gain.	Ens assegurarem que ningú s'estiga aprofitant del poble americà per al seu propi interès a curt termini.Didn't you know?	No ho sabies?
His arrogance is no longer tolerable.	La seva arrogància ja no és tolerable.
His house was on fire.	La seva casa està en flames.
I'd like some sugar, please.	M'agradaria una mica de sucre, si us plau.
I have two cats.	Tinc dos gats.
She lives nearby.	Viu aquí prop.
What a nice sounding word!	Què bé sona aquesta paraula!
Silence is golden.	Callar val tant com l'or.
The leaves fell from the trees.	Les fulles queien dels arbres.
Human beings are the only animals that laugh.	L'ésser humà és l'únic animal que riu.
Tom doesn't drink.	Tom no beu.
They are artists.	Ells són artistes.
Can you do anything to help Tom?	Pots ajudar el Tom d'alguna forma?
I thought you said you wanted to do that for Tom.	Em pensava que havies dit que ho volies fer per en Tom.
When I got home, I found your letter waiting for me.	Quan vaig arribar a casa, vaig trobar la teva carta esperant-me.
I know that I can't throw a ball very well.	Sé que no tinc la mà trencada a llençar boles.
You're a good person.	Eres bona persona.
Take off your socks, please.	Lleveu-vos els calcetins, per favor.
Tom's arm had to be amputated.	Van haver d'amputar el braç al Tom.
I hate chemistry.	Odio la química.
We would have bought the plane tickets if the price had been a little lower.	Hauríem comprat els bitllets d'avió si el preu fos un pèl més baix.
Are you crying?	Que plores?
Take off your socks, please.	Lleva't els calcetins, per favor.
He plays baseball every day.	Juga al beisbol tots el dies.
Tom is thirty years old.	Tom té trenta anys.
Do you think this image has been manipulated?	Creus que esta imatge ha sigut manipulada?
I don't know when he will come.	No sé quan vindrà.
I'd like to rent a car.	Voldria llogar un cotxe.
What is going on?	Què hi ha?
He is a good athlete.	Ell és un bon atleta.
I'm a professional photographer.	Jo sóc fotògraf professional.
You agree with Tom, don't you?	Estàs d'acord amb Tom, no?
Have you eaten dinner?	Ja heu sopat?
What horrible weather!	Quin temps tan dolent!
